105
1
3
0
4444444444444444444444
4444444444444001002044
4444000000044666666694
4440044244004666664644
4440491244408200000004
4440444144424444444444
4440000000421900000004
4444444440004000660004
4444444444444000000004
4000000000000000000004
4000000000000000000004
4444444444444444444444