4444444444444444444444
4494000000000444444444
4020000043144440000944
4000044449044440044244
4402040044444440041944
4404000000007000011144
4400444012421453440004
4924444449000444440004
4410000044444494400214
4444442001010121204044
4080000010101000004094
4444444444444444444444