4444444444
4900000094
4000000004
4444442224
4980000094
4444444444